XXXXXXXXXXXXXXX
#####o###o#####
#.............#
#.##._____.##.#
#.##._____.##.#
#.[o._____.o[.#
#.............#
#.__.#####.__.#
#.__.#XXX#.__.#
#.__.#XXX#.__.#
#.__.o###o.__.#
#.............#
#.##._____.##.#
#.##._____.##.#
#.[o._____.o[.#
#......@......#
###############